1111111111111
10C1M00E000C1
100001000C001
1P0C01EM00M01
111111111E111
1101101000111
1101101111011
1110001000011
1111101011111
1111101100011
111111E101111
1111111111111